б	большая
г	год
гг	год
д	дом
к	корпус
л	литр
м	метро	машина
п	проспект
р	рубль
руб рубль
с	счет	строение
т	телефон
ч	час	человек
ш	шоссе
ул	улица
пл	площадь
пр	проспект
ст	станция
вл	владение
эт	этаж
тр	тысяча рублей
пн	понедельник
вт	вторник
ср	среда
чт	четверг
пт	пятница
сб	суббота
вс	воскресение	
оф	офис	официальность
тв	телевизор
нг	новый год
ув	уважаемый
гб	гигабайт
юв	ювелирный
тц	торговый центр
дц	дилинговый центр
ац	автомобильный центр
мц	медицинский центр
тк	торговый центр
ск	спортивный комплекс
дк	дом культуры		
см	сантиметр
км	километр
мл	миллилитр
кг	килограмм
мо	московская область
гг	год
дн	день
руб	рубль
тыс	тысяча
млн	миллион
коп	копейка
смс	сообщение
тел	телефон
инф	информация
моб	мобильный
трк	торговый центр
гум	торговый центр
стц	торговый центр
сен	сентябрь
окт	октябрь
дек	декабрь
янв	январь
фев	февраль
апр	апрель
авг	август
мрн	микрорайон
мкр	микрорайон
маг	магистраль
наб	набережная
обл	область
пер	переулок
стр	строение
ост	остановка
сто	станция технического обслуживания
дпс	дорога патруль служба
жкх	жилище коммунальное хозяйство
муж	мужчина
жен	женщина
ген	генеральный
тех	технический
чел	человек
доб	добавочный
зап	запись
муз	музыка
вкл	включение
доп	дополнительный
азс	автомобиль заправка станция
шин	шина
млрд миллиард
инфо	информация
авто	автомобиль
спец	специальный
нояб	ноябрь
уваж	уважаемый
офиц	официальный
бесп	бесплатно
зимн	зима
вскр	воскресение
подр	подробность
комн	комната
мкрн	микрорайон
США соединение штат америка
ФАС	федерация антимонополия служба
МИД	министерство иностранец дело
РФ	россия федерация
ОБСЕ	организация безопасность сотрудничество Европа
ФСБ	федерация служба безопасность
NYT	газета америка
ОПЕК	организация страна экспорт нефть
ДТП	дорога транспорт происшествие
Су-27	самолет
Су	самолет
МВФ	Москва венчур форум
РФПЛ	россия футбол премьер лига
ХМАО	ханты-мансийск автономия округ
ВКП	воздух кабель переход
РЖД	Россия железная дорога
ФНБ	фонд нация благосостояние
ИГ	ислам государство
ЕС	Европа союз
ТАСС	информация телеграф агенство Россия
ЦБ	центр банк
ДУ	дом ученый
ГУ	государство учреждение
рспп	Россия союз промышленник предприниматель
атс	автомат телефон станция
тв телевизор
нато союз политика европа канада америка
сми средство масса информация
вич вирус иммунитет дефицит человек
мвд министерство внутренний дело
пво против воздух оборона
мкжд москва кольцо железо дорога
оон организация объединение нация
мск москва
ввп вал внутри продукт
снг содружество непризнание государство
ооо общество ограничение ответственность
ссср союз совет социализм республика
оао открытость акция общество
