еще		него
а	в ж	нее		со
без		же	ней 	так
больше	за	нет		такой
будет	зачем	ни	там
будто	нибудь	тебя
бы	и	никогда		тем
был		из	ним		теперь
была	из-за	них		то
были	или		ничего	тогда
было	им	но	того
быть	иногда	ну	тоже
в	их	о	только
вам		к	об	том
вас		тот
вдруг	как		он
ведь	какая	она	тут
во	какой	они		ты
вот		когда	опять	у
впрочем		конечно	от	уж
все		которого	перед	уже
всегда	которые		по
всего	кто		под		хоть
всех	куда	после	чего
всю		ли	потом
вы	потому	чем
г	между	почти	через
где		меня	при		что
мне		про		чтоб
да	раз		чтобы
даже	может	разве	чуть
два		можно	с	эти
для		мой		сам		этого
до	моя		свое	этой
мы	свою	этом
его	на	себе	этот
ее	над		себя	эту
ей	я
ему		
если	нас	
есть

